* * * * *
* * * O *
* O * * *
* A * * *
* * * * *