* * * * *
* * M O *
* O * * *
* A * M *
* * * * *