A * * O * * A
* * * O * * *
* * * * * * *
M * * O * * M
* * * * * * *
* * * O * * *
A * * O * * A