O * * O * * O
* * * O * * *
* * * * * * *
M * * O * * M
* * * * * * *
* * * O * * *
O * * O * * O
