* * * * * * * * * * * *
O O O O * * * * * * * *
* A * A * * * * * * * *
* M * M * * * * * * * *
* * * * * * * * * * * *
* * * * * * * * * * * *
O O O O * * * * * * * *
* A * A * * * * * * * *
* M * M * * * * * * * *
* * * * * * * * * * * *